1111111111111111111111111111111111111111111111111111111111111111111111111111111111111111111111111111
1P0C000000000000000000000000000000000000C101000111010100111001011111111010010010C1000010101110110001
1001010011000000000000000000000000000101101010000001011110010010001111111101010000100110100000110001
1111111011001001111001000001101111100010111111001101010000010110100000111100100101000111101000011001
100110100100010110001101001010011010000000000000000000000000C100100001000100110000111111100110110011
1101101111C00000000000000000000000000011001111010111001111101001110011111110100100111111110000101111
1010111011101110000100111001010001100000000000000000000000000000000000000000000000110110001100110011
1000111111C00000000000000000000000000000000000000000000000000000000000000000000001010111101110011111
11010000111011001111110101111101101101111011101000110001011101011000000000000000000000000000000E0111
1111111111111111111111111111111111111111111111111111111111111111111111111111111111111111111111111111
